XXXXXXXXXXXXXXXXXXXXXXXXXXXXXXXXXXXXXXXXXXXXX
X        X               XXX                X
X        X        I      XXX                X
X        X                                  X
X        X     II                     I     X
X        X                 I                X
X        X               XXX                X
XXXXXXXX II  XXXXXXXXXXXXXXXXXXXXXXXXX      X
X                     XXXX                  X
X  XXX                XXXX                  X
X            XXX      XXXX        II        X
X    I                XXXX      XXXXXXXXXXXXX
X         I           XXXX              I   X
X               I     XXXX  I               X
X     XXX             XXXX        XXX       X
X                     XXXX        XXX       X
X                     XXXX                  X
X          XXX     XXXXXXXXXXXXXXXXXXXXX    X
X                              X       X    X
X             I                X       X    X
X     XXX               I      X       X   IX
X                              X       X    X
X                XXX           X       X    X
X      I                       X       X    X
X                                      XI   X
X                        XXX           X    X
XXXXXXXXXXXXXXXXXXXXXXXXXXXXXXXXX      X    X
X                             I        X    X
X        I                             X    X
X   I          XXX        I            X   SX
X              XXX   IXXXXXXXXXXXXXXXXXXXXXXX
X       I      XXX                          X
X              XXX                  I       X
X   I          XXX          I               X
X         I    XXX                  I       X
X              XXX            I             X
X              XXX                          X
XXXXXXXXXXXXXXXXXXXXXXXXXXXXXXXXXXXXXXXX    X
X                                           X
X                 X                         X
X   XXXXXXX        X                        X
X         X      I  X                       X
X         X    I     X                      X
X         X           X           I         X
X         X            X                    X
X         X                                 X
XXXX      X      I                          X
X      X  X   I                             X
XP     X  X               I                 X
XXXXXXXXXXXXXXXXXXXXXXXXXXXXXXXXXXXXXXXXXXXXX